111111111111111111111111111111111111111111111111111111111111111111111111111111111111111111111111
300000000000000000000000000000000000000000000000000000000000000000000000000000000000000000000003
300000000000000000000000000000000000000000000000000000000000000000000000000000000000000000000003
300000000000000000000000000000000000000000000000000000000000000000000000000000000000000000000003
300000000000000000000000000000000000000000000000000000000000000000000000000000000000000000000003
300000000000000000000000000000000000000000000000000000000000000000000000000000000000000000000003
300000000000000000000000000000000000000000000000000000000000000000000000000000000000000000000003
300000000000000000000000000000000000000000000000000000000000000000000000000000000000000000000003
300000000000000000000000000000000000000000000000000000000000000000000000000000000000000000000003
300000000000000000000000000000000000000000000000000000000000000000000000000000000000000000000003
300000000000000000000000000000000000000000000000000000000000000000000000000000000000000000000003
300000000000000000000000000000000000000000000000000000000000000000000000000000000000000000000003
300000000000000000000000000000000000000000000000000000000000000000000000000000000000000000000003
300000000000000000000000000000000000000000000000000000000000000000000000000000000000000000000003
300000000000000000000000000000000000000000000000000000000000000000000000000000000000000000000003
300000000000000000000000000000000000000000000000000000000000000000000000000000000000000000000003
300000000000000000000000000000000000000000000000000000000000000000002000000000000000000000000003
300000000000000000000000000000000000000000000000000000000000011111111111100000000000000000000003
300000000000000000000000000000000000000000002000000000000000000000000000000000000000000000000003
300000000000000000000000000000000000000000001111100000000000000000000000000000000000000000000003
300000000000000000000000000000000000000000000000000000000000000000000000000000000000000000000003
300000000000000000000000000000000000000000000000000000002000000000000000000000000000000000000004              11111111111111111111111111111111111111
300000000000000000000000000000000000000000000000000000111110000000000000000000000000000000000004
300000000000000000000000000000000000000000001110000000000000000000000000000000000000000000000004
300000000000000000000000000000000000000000000000000000000000000000000000000000000000000000000004
300000000000000000000000000000000000000000000000010000000002000000000000000000000000000000000004
111111111111111111111111111111111111111111111111111111111111111111111111111111111111111111111111