111111111111111111111111111111111111111111111111111111111111111111111111111111111111111111111111
300000000000000000000000000000000000000000000000000000000000000000000000000000000000000000000003
300000000000000000000000000000000000000000000000000000000000000000000000000000000000000000000003
300000000000000000000000000000000000000000000000000000000000000000000000000000000000000000000003
300000000000000000000000000000000000000000000000000000000000000000000000000000000000000000000004
300000000000000000000000000000000000000000000000000000000000000000000000000000000000000000000004
300000000000000000000000000000000000000000000000000000000000000000000000000000000000000000000004
300000000000000000000000000000000000000000000000000000000000000000000000000000000000000000000004
300000000000000000000000000000000000000000000000000000000000000000000000000000000000000000000004
300000000000000000000000000000000000000000000000000000000000000000000000000000000001111100000003
300000000000000000000000000000000000000000000000000000000000000000000000000000000000000000000003
300000000000000000000000000000000000000000000000000000000000000000000000000000000003000000000003
300000000000000000000000000000000000000000000000000000000000000000000011110000000003000000000003
300000000000000000000000000000000000000000000000000000000000000000000000000000000003000000000003
300000000000000000000000000000000000000000000000000000000000000000000000000000000003000000000003
300000000000000000000000000000000000000000000000000000000000000000000000000000000003000000000003
300000000000000000000000000000000000000000000000000000000000000000000000000000000003000000000003
300000000000000000000000000000000000000000000000000000000000000000000000000000000003000000000003
300000000000000000000000000000000000000000000000000000000000000000000000000000000003000000000003
300000000000000000000000000000000000000000000000000000000000000000000000000011111111000000000003
300000000000000000000000000000000000030000000000000000000000000000000000000000000000000000000003
300000000000000000000000000000000000030000000000000000111100000000000000000000000000000000000003
300000000000000000000000000000000000030000000000000000000000000000000000000000000000000000000003
300000000000000000000000000000000000030000000000011111100000000000000000000000000000000000000003
300000000000000000000000000000000000030000000000000000000000000000000000000000000000000000000003
300000000000000000000000000000000200032222222222222222222222222222222222222222222222222222222223
111111111111111111111111111111111111111111111111111111111111111111111111111111111111111111111111